49 45
2 2 2 3 2 2 2 2 2 2 2 2 2 2 2 2 2 2 2 2 2 2 2 2 2 2 2 2 2 2 2 2 2 2 2 2 2 2 2 2 2 2 2 2 2 2 2 2 2
0 1 1 4 1 1 1 1 1 1 1 1 1 1 1 1 1 1 1 0 1 1 4 1 1 1 1 1 1 1 1 1 1 1 1 1 1 1 0 1 1 1 1 1 1 1 1 1 0
0 1 1 4 1 1 1 6 1 1 1 1 1 1 1 1 1 1 1 0 1 1 4 1 1 1 1 1 1 1 1 1 1 1 1 1 1 1 0 1 1 1 1 1 1 1 1 1 0
0 1 1 4 1 1 6 6 1 1 1 1 6 6 1 1 1 1 1 0 1 1 4 1 1 1 1 1 1 1 1 1 1 1 1 1 1 1 4 1 1 1 1 1 1 1 1 1 0
0 1 1 4 1 1 1 1 1 1 1 1 6 6 1 1 1 1 1 0 1 1 4 1 1 1 1 1 1 1 1 1 1 1 1 1 1 1 4 1 1 1 1 1 1 1 1 1 0
0 1 1 4 1 1 6 1 1 1 1 1 1 1 1 1 1 1 1 0 1 1 4 1 1 1 1 1 1 1 1 1 1 1 1 1 1 1 0 1 1 1 1 1 1 1 1 1 0
0 1 1 4 1 1 1 1 1 1 1 1 1 1 1 1 1 1 1 0 1 1 4 1 1 1 1 1 1 1 1 1 1 1 1 1 1 1 0 1 1 1 1 1 1 1 1 1 0
0 1 1 4 1 1 1 1 1 1 1 1 1 1 1 1 1 1 1 0 1 1 4 1 1 1 1 1 1 1 1 1 1 1 1 1 1 1 0 1 1 1 1 1 1 1 1 1 0
0 1 1 4 1 1 1 1 1 1 1 1 1 1 1 1 1 1 1 0 1 1 4 1 1 1 1 1 1 1 1 1 1 1 1 1 1 1 0 1 1 1 1 1 1 1 1 1 0
0 1 1 4 1 1 1 1 1 1 1 1 1 1 1 1 1 1 1 0 1 1 4 1 1 1 1 1 1 1 1 1 1 1 1 1 1 1 0 1 1 1 1 1 1 1 1 1 0
0 1 1 4 4 4 4 4 4 4 4 5 5 5 5 5 1 1 1 0 1 1 4 1 1 1 1 1 1 1 1 1 1 1 1 1 1 1 0 1 1 1 1 1 1 1 1 1 0
0 1 1 4 1 1 1 1 1 1 1 1 1 1 1 1 1 1 1 0 1 1 4 1 1 1 1 1 1 1 1 1 1 1 1 1 1 1 0 1 1 1 1 1 1 1 1 1 0
0 1 1 4 1 1 1 1 1 1 1 1 1 1 1 1 1 1 1 0 1 1 4 1 1 1 1 1 1 1 1 1 1 1 1 1 1 1 0 1 1 1 1 1 1 1 1 1 0
0 1 1 4 1 1 1 1 1 1 1 1 1 1 1 1 1 1 1 4 1 1 4 1 1 1 1 1 1 1 1 1 1 1 1 1 1 1 0 1 1 1 1 1 1 1 1 1 0
0 1 1 4 1 1 1 1 1 1 1 1 1 1 1 1 1 1 1 4 1 1 4 1 1 1 1 1 1 1 1 1 1 1 1 1 1 1 0 1 1 1 1 1 1 1 1 1 0
0 1 1 4 1 1 1 1 1 1 1 1 1 1 1 1 1 1 1 0 1 1 4 1 1 1 1 1 1 1 1 1 1 1 1 1 1 1 0 1 1 1 1 1 1 1 1 1 0
0 1 1 4 1 1 1 1 1 1 1 1 1 1 1 1 1 1 1 0 1 1 4 1 1 1 1 1 1 1 1 1 1 1 1 1 1 1 0 1 1 1 1 1 1 1 1 1 0
0 1 1 4 1 1 1 1 1 1 1 1 1 1 1 1 1 1 1 0 1 1 4 1 1 1 1 1 1 1 1 1 1 1 1 1 1 1 0 1 1 1 1 1 1 1 1 1 0
0 1 1 4 1 1 1 1 6 6 6 6 6 6 1 1 1 1 1 0 1 1 4 1 1 1 1 1 1 1 1 1 1 1 1 1 1 1 0 1 1 1 1 1 1 1 1 1 0
0 1 1 4 1 1 1 1 1 1 1 1 1 1 1 1 1 1 1 0 1 1 4 1 1 1 1 1 1 1 1 1 1 1 1 1 1 1 0 1 1 1 1 1 1 1 1 1 0
0 1 1 4 1 1 1 1 1 1 1 1 1 1 1 1 1 1 1 0 1 1 4 1 1 1 1 1 1 1 1 1 1 1 1 1 1 1 0 1 1 1 1 1 1 1 1 1 0
0 1 1 4 1 1 1 1 1 1 1 1 1 1 1 1 1 1 1 0 1 1 4 1 1 1 1 1 1 1 1 1 1 1 1 1 1 1 0 1 1 1 1 1 1 1 1 1 0
0 0 0 4 0 0 0 0 0 0 0 0 0 0 0 0 0 0 0 0 1 1 4 1 1 1 1 1 1 1 1 1 1 1 1 1 1 1 0 1 1 1 1 1 1 1 1 1 0
0 1 1 4 1 1 1 1 1 1 1 1 1 1 1 1 1 1 1 0 1 1 4 1 1 1 1 1 1 1 1 1 1 1 1 1 1 1 0 1 1 1 1 1 1 1 1 1 0
0 1 1 4 1 1 1 6 1 1 1 1 1 1 1 1 1 1 1 0 1 1 4 1 1 1 1 1 1 1 1 1 1 1 1 1 1 1 0 1 1 1 1 1 1 1 1 1 0
0 1 1 4 1 1 6 6 1 1 1 1 6 6 1 1 1 1 1 0 1 1 4 1 1 1 1 1 1 1 1 1 1 1 1 1 1 1 0 1 1 1 1 1 1 1 1 1 0
0 1 1 4 1 1 1 1 1 1 1 1 6 6 1 1 1 1 1 0 1 1 4 1 1 1 1 1 1 1 1 1 1 1 1 1 1 1 0 1 1 1 1 1 1 1 1 1 0
0 1 1 4 1 1 6 1 1 1 1 1 1 1 1 1 1 1 1 0 1 1 4 1 1 1 1 1 1 1 1 1 1 1 1 1 1 1 0 1 1 1 1 1 1 1 1 1 0
0 1 1 4 1 1 1 1 1 1 1 1 1 1 1 1 1 1 1 0 1 1 4 1 1 1 1 1 1 1 1 1 1 1 1 1 1 1 0 1 1 1 1 1 1 1 1 1 0
0 1 1 4 1 1 1 1 1 1 1 1 1 1 1 1 1 1 1 0 1 1 4 1 1 1 1 1 1 1 1 1 1 1 1 1 1 1 0 1 1 1 1 1 1 1 1 1 0
0 1 1 4 1 1 1 1 1 1 1 1 1 1 1 1 1 1 1 0 1 1 4 1 1 1 1 1 1 1 1 1 1 1 1 1 1 1 0 1 1 1 1 1 1 1 1 1 0
0 1 1 4 1 1 1 1 1 1 1 1 1 1 1 1 1 1 1 0 1 1 4 1 1 1 1 1 1 1 1 1 1 1 1 1 1 1 0 1 1 1 1 1 1 1 1 1 0
0 1 1 4 4 4 4 4 4 4 4 5 5 5 5 5 1 1 1 0 1 1 4 1 1 1 1 1 1 1 1 1 1 1 1 1 1 1 0 1 1 1 1 1 1 1 1 1 0
0 1 1 4 1 1 1 1 1 1 1 1 1 1 1 1 1 1 1 0 1 1 4 1 1 1 1 1 1 1 1 1 1 1 1 1 1 1 0 1 1 1 1 1 1 1 1 1 0
0 1 1 4 1 1 1 1 1 1 1 1 1 1 1 1 1 1 1 4 1 1 4 1 1 1 1 1 1 1 1 1 1 1 1 1 1 1 0 1 1 1 1 1 1 1 1 1 0
0 1 1 4 1 1 1 1 1 1 1 1 1 1 1 1 1 1 1 4 1 1 4 1 1 1 1 1 1 1 1 1 1 1 1 1 1 1 0 1 1 1 1 1 1 1 1 1 0
0 1 1 4 1 1 1 1 1 1 1 1 1 1 1 1 1 1 1 0 1 1 4 1 1 1 1 1 1 1 1 1 1 1 1 1 1 1 0 1 1 1 1 1 1 1 1 1 0
0 1 1 4 1 1 1 1 1 1 1 1 1 1 1 1 1 1 1 0 1 1 4 1 1 1 1 1 1 1 1 1 1 1 1 1 1 1 4 1 1 1 1 1 1 1 1 1 0
0 1 1 4 1 1 1 1 1 1 1 1 1 1 1 1 1 1 1 0 1 1 4 1 1 1 1 1 1 1 1 1 1 1 1 1 1 1 4 1 1 1 1 1 1 1 1 1 0
0 1 1 4 1 1 1 1 1 1 1 1 1 1 1 1 1 1 1 0 1 1 4 1 1 1 1 1 1 1 1 1 1 1 1 1 1 1 0 1 1 1 1 1 1 1 1 1 0
0 1 1 4 1 1 1 1 6 6 6 6 6 6 1 1 1 1 1 0 1 1 4 1 1 1 1 1 1 1 1 1 1 1 1 1 1 1 0 1 1 1 1 1 1 1 1 1 0
0 1 1 4 1 1 1 1 1 1 1 1 1 1 1 1 1 1 1 0 1 1 4 1 1 1 1 1 1 1 1 1 1 1 1 1 1 1 0 1 1 1 1 1 1 1 1 1 0
0 1 1 4 1 1 1 1 1 1 1 1 1 1 1 1 1 1 1 0 1 1 4 1 1 1 1 1 1 1 1 1 1 1 1 1 1 1 0 1 1 1 1 1 1 1 1 1 0
0 1 1 4 1 1 1 1 1 1 1 1 1 1 1 1 1 1 1 0 1 1 4 1 1 1 1 1 1 1 1 1 1 1 1 1 1 1 0 1 1 1 1 1 1 1 1 1 0
0 0 0 4 0 0 0 0 0 0 0 0 0 0 0 0 0 0 0 0 0 0 4 0 0 0 0 0 0 0 0 4 0 0 0 0 0 0 0 0 0 0 0 0 4 0 0 0 0



