49 45
10 10 10 8 10 10 10 10 10 10 10 10 10 10 10 10 10 10 10 10 10 10 10 10 10 10 10 10 10 10 10 10 10 10 10 10 10 10 10 10 10 10 10 10 3 10 10 10 10
9 7 7 8 7 7 7 7 7 7 7 7 7 7 7 7 7 7 7 9 7 7 8 7 7 7 7 7 7 7 7 7 7 7 7 7 7 7 9 7 7 7 7 7 8 7 7 7 9
9 7 7 8 7 7 7 7 7 7 7 7 7 7 7 7 7 7 7 9 7 7 8 7 7 7 7 7 7 7 7 7 7 7 7 7 7 7 9 7 7 7 7 7 8 7 7 7 9
9 7 7 8 7 7 7 7 7 7 7 7 7 7 7 7 7 7 7 9 7 7 8 7 7 7 7 7 7 7 7 7 7 7 7 7 7 7 8 7 7 7 7 7 8 7 7 7 9
9 7 7 8 7 7 7 7 7 7 7 7 7 7 7 7 7 7 7 9 7 7 8 7 7 7 7 7 7 7 7 7 7 7 7 7 7 7 8 7 7 7 7 7 8 7 7 7 9
9 7 7 8 7 7 7 7 7 7 7 7 7 7 7 7 7 7 7 9 7 7 8 7 7 7 7 7 7 7 7 7 7 7 7 7 7 7 9 7 7 7 7 7 8 7 7 7 9
9 7 7 8 7 7 7 7 7 7 7 7 7 7 7 7 7 7 7 9 7 7 8 7 7 7 7 7 7 7 7 7 7 7 7 7 7 7 9 7 7 7 7 7 7 7 7 7 9
9 7 7 8 7 7 7 7 7 7 7 7 7 7 7 7 7 7 7 9 7 7 8 7 7 7 7 7 7 7 7 7 7 7 7 7 7 7 9 7 7 7 7 7 7 7 7 7 9
9 7 7 8 7 7 7 7 7 7 7 7 7 7 7 7 7 7 7 9 7 7 8 7 7 7 7 7 7 7 7 7 7 7 7 7 7 7 9 7 7 7 7 7 7 7 7 7 9
9 7 7 8 7 7 7 7 7 7 7 7 7 7 7 7 7 7 7 9 7 7 8 7 7 7 7 7 7 7 7 7 7 7 7 7 7 7 9 7 7 7 7 7 7 7 7 7 9
9 7 7 8 8 8 8 8 8 8 8 7 7 7 7 7 7 7 7 9 7 7 8 7 7 7 7 7 7 7 7 7 7 7 7 7 7 7 9 7 7 7 7 7 7 7 7 7 9
9 7 7 8 7 7 7 7 7 7 7 7 7 7 7 7 7 7 7 9 7 7 8 7 7 7 7 7 7 7 7 7 7 7 7 7 7 7 9 7 7 7 7 7 7 7 7 7 9
9 7 7 8 7 7 7 7 7 7 7 7 7 7 7 7 7 7 7 9 7 7 8 7 7 7 7 7 7 7 7 7 7 7 7 7 7 7 9 7 7 7 7 7 7 7 7 7 9
9 7 7 8 7 7 7 7 7 7 7 7 7 7 7 7 7 7 7 8 7 7 8 7 7 7 7 7 7 7 7 7 7 7 7 7 7 7 9 7 7 7 7 7 7 7 7 7 9
9 7 7 8 7 7 7 7 7 7 7 7 7 7 7 7 7 7 7 8 7 7 8 7 7 7 7 7 7 7 7 7 7 7 7 7 7 7 9 7 7 7 7 7 7 7 7 7 9
9 7 7 8 7 7 7 7 7 7 7 7 7 7 7 7 7 7 7 9 7 7 8 7 7 7 7 7 7 7 7 7 7 7 7 7 7 7 9 7 7 7 7 7 7 7 7 7 9
9 7 7 8 7 7 7 7 7 7 7 7 7 7 7 7 7 7 7 9 7 7 8 7 7 7 7 7 7 7 7 7 7 7 7 7 7 7 9 7 7 7 7 7 7 7 7 7 9
9 7 7 8 7 7 7 7 7 7 7 7 7 7 7 7 7 7 7 9 7 7 8 7 7 7 7 7 7 7 7 7 7 7 7 7 7 7 9 7 7 7 7 7 7 7 7 7 9
9 7 7 8 7 7 7 7 7 7 7 7 7 7 7 7 7 7 7 9 7 7 8 7 7 7 7 7 7 7 7 7 7 7 7 7 7 7 9 7 7 7 7 7 7 7 7 7 9
9 7 7 8 7 7 7 7 7 7 7 7 7 7 7 7 7 7 7 9 7 7 8 7 7 7 7 7 7 7 7 7 7 7 7 7 7 7 9 7 7 7 7 7 7 7 7 7 9
9 7 7 8 7 7 7 7 7 7 7 7 7 7 7 7 7 7 7 9 7 7 8 7 7 7 7 7 7 7 7 7 7 7 7 7 7 7 9 7 7 7 7 7 7 7 7 7 9
9 7 7 8 7 7 7 7 7 7 7 7 7 7 7 7 7 7 7 9 7 7 8 7 7 7 7 7 7 7 7 7 7 7 7 7 7 7 9 7 7 7 7 7 7 7 7 7 9
9 9 9 8 9 9 9 9 9 9 9 9 9 9 9 9 9 9 9 9 7 7 8 7 7 7 7 7 7 7 7 7 7 7 7 7 7 7 9 7 7 7 7 7 7 7 7 7 9
9 7 7 8 7 7 7 7 7 7 7 7 7 7 7 7 7 7 7 9 7 7 8 7 7 7 7 7 7 7 7 7 7 7 7 7 7 7 9 7 7 7 7 7 7 7 7 7 9
9 7 7 8 7 7 7 7 7 7 7 7 7 7 7 7 7 7 7 9 7 7 8 7 7 7 7 7 7 7 7 7 7 7 7 7 7 7 9 7 7 7 7 7 7 7 7 7 9
9 7 7 8 7 7 7 7 7 7 7 7 7 7 7 7 7 7 7 8 8 8 8 7 7 7 7 7 7 7 7 7 7 7 7 7 7 7 9 7 7 7 7 7 7 7 7 7 9
9 7 7 8 7 7 7 7 7 7 7 7 7 7 7 7 7 7 7 9 7 7 8 7 7 7 7 7 7 7 7 7 7 7 7 7 7 7 9 7 7 7 7 7 7 7 7 7 9
9 7 7 8 7 7 7 7 7 7 7 7 7 7 7 7 7 7 7 9 7 7 8 7 7 7 7 7 7 7 7 7 7 7 7 7 7 7 9 7 7 7 7 7 7 7 7 7 9
9 7 7 8 7 7 7 7 7 7 7 7 7 7 7 7 7 7 7 9 7 7 8 7 7 7 7 7 7 7 7 7 7 7 7 7 7 7 9 7 7 7 7 7 7 7 7 7 9
9 7 7 8 7 7 7 7 7 7 7 7 7 7 7 7 7 7 7 9 7 7 8 7 7 7 7 7 7 7 7 7 7 7 7 7 7 7 9 7 7 7 7 7 7 7 7 7 9
9 7 7 8 7 7 7 7 7 7 7 7 7 7 7 7 7 7 7 9 7 7 8 7 7 7 7 7 7 7 7 7 7 7 7 7 7 7 9 7 7 7 7 7 7 7 7 7 9
9 7 7 8 7 7 7 7 7 7 7 7 7 7 7 7 7 7 7 9 7 7 8 7 7 7 7 7 7 7 7 7 7 7 7 7 7 7 9 7 7 7 7 7 7 7 7 7 9
9 7 7 8 8 8 8 8 8 8 8 7 7 7 7 7 7 7 7 9 7 7 8 7 7 7 7 7 7 7 7 7 7 7 7 7 7 7 9 7 7 7 7 7 7 7 7 7 9
9 7 7 8 7 7 7 7 7 7 7 7 7 7 7 7 7 7 7 9 7 7 8 7 7 7 7 7 7 7 7 7 7 7 7 7 7 7 9 7 7 7 7 7 7 7 7 7 9
9 7 7 8 7 7 7 7 7 7 7 7 7 7 7 7 7 7 7 9 7 7 8 7 7 7 7 7 7 7 7 7 7 7 7 7 7 7 9 7 7 7 7 7 7 7 7 7 9
9 7 7 8 7 7 7 7 7 7 7 7 7 7 7 7 7 7 7 9 7 7 8 7 7 7 7 7 7 7 7 7 7 7 7 7 7 7 9 7 7 7 7 7 7 7 7 7 9
9 7 7 8 7 7 7 7 7 7 7 7 7 7 7 7 7 7 7 9 7 7 8 7 7 7 7 7 7 7 7 7 7 7 7 7 7 7 9 7 7 7 7 7 7 7 7 7 9
9 7 7 8 7 7 7 7 7 7 7 7 7 7 7 7 7 7 7 9 7 7 8 7 7 7 7 7 7 7 7 7 7 7 7 7 7 7 9 7 7 7 7 7 7 7 7 7 9
9 7 7 8 7 7 7 7 7 7 7 7 7 7 7 7 7 7 7 9 7 7 8 8 8 8 8 8 8 8 8 8 8 8 8 8 8 8 8 7 7 7 7 7 7 7 7 7 9
9 7 7 8 7 7 7 7 7 7 7 7 7 7 7 7 7 7 7 9 7 7 7 7 7 7 7 7 7 7 7 8 7 7 7 7 7 7 9 7 7 7 7 7 7 7 7 7 9
9 7 7 8 7 7 7 7 7 7 7 7 7 7 7 7 7 7 7 9 7 7 7 7 7 7 7 7 7 7 7 8 7 7 7 7 7 7 9 7 7 7 7 7 7 7 7 7 9
9 7 7 8 7 7 7 7 7 7 7 7 7 7 7 7 7 7 7 9 7 7 7 7 7 7 7 7 7 7 7 8 7 7 7 7 7 7 9 7 7 7 7 7 7 7 7 7 9
9 7 7 8 7 7 7 7 7 7 7 7 7 7 7 7 7 7 7 9 7 7 7 7 7 7 7 7 7 7 7 8 7 7 7 7 7 7 9 7 7 7 7 7 7 7 7 7 9
9 7 7 8 7 7 7 7 7 7 7 7 7 7 7 7 7 7 7 9 7 7 7 7 7 7 7 7 7 7 7 8 7 7 7 7 7 7 9 7 7 7 7 7 7 7 7 7 9
9 9 9 9 9 9 9 9 9 9 9 9 9 9 9 9 9 9 9 9 9 9 9 9 9 9 9 9 9 9 9 8 9 9 9 9 9 9 9 9 9 9 9 9 9 9 9 9 9



